#############
# O         #
#       #   #
#           #
#######     #
# O  ##     #
#    ##     #
#  P        #
#       XX  #
#     #     #
#############
